################################################################
#..............................................................#
#..............................................................#
#..............................................................#
#..............................................................#
#..............................................................#
#..............................................................#
#..............................................................#
#....................#.........................................#
#....................#.........................................#
#....................#.........................................#
#....................#.........................................#
#....................#.........................................#
#....................#.........................................#
#....................#.........................................#
#....................#.........................................#
#....................#.........................................#
#....................#.........................................#
######################.........................................#
#..............................................................#
#..............................................................#
#..............................................................#
#..............................................................#
#..............................................................#
#..............................................................#
#..............................................................#
#..............................................................#
#..............................................................#
#.................##############################################
#..............................................................#
#..............................................................#
#..............................................................#
#..............................................................#
#..............................................................#
#..............................................................#
#..............................................................#
#..............................................................#
#######################################........................#
#.....................................#........................#
#.....................................#........................#
#.....................................#........................#
#.....................................#........................#
#.....................................#........................#
#.....................................#........................#
#.....................................#........................#
#.....................................#........................#
#.....................................#........................#
#.....................................#........................#
#.....................................#........................#
#.....................................#........................#
#.....................................#........................#
#................######################........................#
#..............................................................#
#..............................................................#
#..............................................................#
#..............................................................#
#..............................................................#
#..............................................................#
#..............................................................#
#..............................................................#
#..............................................................#
#..............................................................#
#..............................................................#
################################################################
