################################################################
######################.........................................#
######################.........................................#
######################.........................................#
######################.........................................#
######################.........................................#
######################............##################...........#
######################............##################...........#
######################............##...........................#
######################............##...........................#
######################............##...........................#
######################............##...........................#
######################............##...........................#
######################............##...........................#
######################............##...........................#
######################............##...........................#
######################............##..........##################
######################............##..........##################
######################............##......................######
#.................................##......................######
#.................................##......................######
#.................................##......................######
#.................................##......................######
#.................................##......................######
#.................................##......................######
#.................................##......................######
#.................................##......................######
#.................##############################################
#.................##############################################
#..............................................................#
#..............................................................#
#..............................................................#
#..............................................................#
#..............................................................#
#..............................................................#
#..............................................................#
#######################################...........##...........#
#######################################...........##...........#
####.................................##...........##...........#
####.................................##...........##...........#
####.................................##...........##...........#
####.................................##...........##...........#
####.................................##...........##...........#
####.................................##...........##...........#
####.................................##...........##...........#
####.................................##...........##...........#
####.................................##...........##...........#
####.................................##...........##...........#
####.................................##...........##...........#
####.................................##...........##...........#
####..........#########################...........##...........#
####..........#########################...........##...........#
####..............................................##...........#
####..............................................##...........#
####..............................................##...........#
####..............................................##...........#
####..............................................##...........#
####..............................................##...........#
####################################################...........#
####################################################...........#
####################################################...........#
####################################################...........#
####################################################...........#
################################################################
